R 1024 760

NO ./textures/WALL52.xpm
SO ./textures/redbrick.xpm
WE ./textures/wood.xpm
EA ./textures/colorstone.xpm

S    ./textures/barrel.xpm
F ./textures/bluestone.xpm
C ./textures/purplestone.xpm


      111111111111111111111111111                     111111111111111111111111111
    111000000000001100000000000011                    100000000011000000000000001
      111011000001110022222000000111111111111111111111101100000111000000000000111
        1001000E00000002222000002222222000000000000000000000000000000000000000001
111111111000000001110000000000001111111111111111111111111111111011000001110000111111111
100001111111100301110111110111111                     111110000011000001110000000000111
110101      11011100000010001            111              11110111111111011100000010001
110101      11011100010010001            101              11110111111111011101010010001
110001      11011100000010001            111              11000000110101011100000010001
100001111111100011000000100011111111111111111111111111111110000000000000001100000010001
110000000000001111010111100000000000000000000000000000000000000011101010111010110100001
1111011111110101 1011110000011111011111110101110111101000111110111111101011101111010001
11111111 1111111 11111111111111111111 1111111 11111111111111111111 1111111 111111111111