R 1024 760

NO ./textures/WALL52.xpm
SO ./textures/redbrick.xpm
WE ./textures/wood.xpm
EA ./textures/colorstone.xpm

S    ./textures/barrel.xpm
F ./textures/WALL52.xpm
C ./textures/wood.xpm


11111111111111111111111111111111
10000000000000000000000000000001
10000000000000000000000000000001
1000000N000000031000000000000001
10000000000000000000000000000001
10000000000000000000000000000001
11111111111111111111111111111111